111111111111
1P00010001E1
100001000101
10100C0T0101
101100010001
111111111111
