111111111111
1E1000011111
101011000111
100C00010011
111111011011
1P00TT011011
111111111111